28 17
BBBBBBBBBBBBBBBBBBBBBBBBBBBB
BBBBBBBB...................B
B..........,xXxXX;.RR......B
E..........Y.....y.RR......e
E..........Y.....Y.........e
B..........Y.....\Xx;......B
B..........Y........Y......B
B..........Y........Y......B
B..........y........y......B
B..........Y........Y......B
B..........Y.RRR.RR.Y......B
B..........Y.RR...R.Y......B
B..........Y........Y....RRB
B,xXXXXXXXx/..R...R.y......B
BY.R.R.R.R....RR.RR.YRR.RR.B
BY..................Y......B
BZBBBBBBBBBBBBBBBBBBzBBBBBBB
